**************
**************
****######****
****#**?*#****
****#@####****
****#*#*******
****#!#*******
****###*******
**************