**************
**************
****######****
****#?***#****
****#**@!#****
****#*!@*#****
****######****
**************
**************

