**************
**************
**##########**
**#?*******#**
**#****@@**#**
**#!****!**#**
**##########**
**************
**************