--------------------
---TT--###---TT-----
-----##*?*##--T-----
---T##******##TT----
-T-##***@****##-----
-T##**@*##****##-T--
-##****#####***##TT-
-##***######***##---
-##****####****##T--
-T##*********!*##---
-T-##********!##--T-
--T-##*******##-T---
---TT-#######--TT---
--TT----TTT----T----
--------------------
