********************
*******###**********
*****##*?*##********
****##******##******
***##***@****##*****
**##**@*##****##****
*##****#####***##***
*##***######***##***
*##****####****##***
**##*********!*##***
***##********!##****
****##*******##*****
******#######*******
********************
********************
