********************
*******#####********
**######***######***
**##***********##***
**####**#@*****##***
*****#****@######***
*****###***#********
*#######***######***
*##****@********#***
*##**####**######***
**#*@###?**#********
**#**####**#####****
**#********!!!!#****
**##############****
********************