--------------------
-TT--TT#####--T-TT--
--######***######T--
-T##***********##-T-
--####**#@*****##---
---T-#****@######---
---TT###***#--TT----
-#######***######-T-
-##****@********#T--
-##**####**######-T-
-T#*@###?**#---TT---
-T#**####**#####-TT-
--#********!!!!#T---
-T##############-TT-
--------------------