********************
********************
******#########*****
******#*******###***
******##***@#***#***
****###**#**#***#***
****#***@#***@**#***
****###******####***
******###****#******
******#!***#*####***
******###*!#****#***
*******##***@***#***
********###**?!!#***
**********#######***
********************