--------------------
--T-----TT---T------
----###########-T---
----#***##****#-TT--
-TT-#*@@***?@*#---T-
----#**###***##-----
----#***@****##-TT--
TT--######!###------
------T-#****#----T-
---TT---#**#*#-TT---
--------#***@####---
-T---######*****#T--
-----#******!!!!#---
--T--############TT-
--------------------