********************
********************
****###########*****
****#***##****#*****
****#*@@***?@*#*****
****#**###***##*****
****#***@****##*****
****######!###******
********#****#******
********#**#*#******
********#***@####***
*****######*****#***
*****#******!!!!#***
*****############***
********************